11111111111111111
10010C00000C00001
10000111110000001
1P001110000000001
11110000000000001
10000011111101001
1000000C100001000
1111111110001C001
10000E00000000001
11111111111111111
